# # # # # # # # # # #
# . . . @ # . . . . #
# . . . . # . # . . #
# . . . . # . # . . #
# . . . . # . # . . #
# . . . . . . # # # #
# . . . . . . . . . #
# # # # # # # # # # #